~~~~~~~~0~~~~
--------D--w.
...........|.
A--w.x---w.|.
...S-s...S-y.
A--y.zw.xy...
......S-s....
A-----y.z--w.
YYYYYYYYY--y.