~~~~~~~@0@~~E
E-------D--w.
...........|.
A--w.x---w.|.
...S-S...S-y.
A--y.zw.xy...
......S-S....
A-----y.z--w.
YYYYYYYYY--y.